English - USA	English - USA	French - France	Brazil - Portuguese
Name of language in that language	English	français	português
Program	Dramatizer	Dramatizer	Dramatizer
language	Language	Langue	Idioma
start new project/open file	Select options	Select options nnnn	Selecione opções
start processing	Start processing	Traitement de début	Processamento de partida
unknown/unidentified speaker	Fix unidentified characters	Fixez des caractères non identifiés	Fixe carateres não identificados
multilple speakers	Verify multiple characters in same verse	Vérifiez des caractères multiples dans même verset	Verifique múltiplos carateres no mesmo verso
verify updated clips	Verify updated clips	Vérifiez des clips actualisés	Verifique clipes atualizados
verify all clips	Verify all clips	Vérifiez tous les clips	Verifique todos os clipes
assign character to speaker	Assign each character to a speaker	Allouez chaque caractère à un speaker	Destine cada caráter a um falante
create scripts	Create scripts and wav files	Créez des scripts et des dossiers wav	Crie escritas e arquivos wav
record	Record	Enregistrer	Gravar
about program	About	De	Sobre
How to quit/end the program	Exit	Quitté	Parar
Next/proceed	Next	Ensuite	Depois
info start project	"You may select several options for the project including the following: (1) file name, (2) text encoding, (3) Ethnologue language code, (4) font name, (5) font size, and (6) first level quote style. |These options will be saved and used for the project. You can return to make changes to your choices at any time. |Click Next to start."	"Vous pouvez choisir plusieurs options pour le projet en incluant les choses suivantes : (1) le nom de dossier, (2) le texte encodant, (3) le code Ethnologue de langue, (4) le nom de fonte, (5) la grandeur de fonte et (6) le style de la citation de premier niveau. | Ces options seront sauvées et utilisées pour le projet. Vous pouvez revenir pour faire des changements à vos choix d'un moment à l'autre. | Faites-un-déclic À côté du début."	"Você pode selecionar várias opções do projeto inclusive o seguinte: (1) nome de arquivo, (2) codificação de texto, (3) Ethnologue langugae código, (4) nome de fonte, (5) tamanho de fonte, e (6) primeiro estilo de citação de nível. |Essas opções serão salvadas e usadas para o projeto. Você pode voltar para fazer modificações às suas escolhas em qualquer momento. |Clique ao Lado da partida."
info start processing file	"A clip is a sentence or group of sentences spoken by one person (or character). In the New Testament, there are between  4,000 to 6,000 clips. Dramatizer can usually identify the character speaking in at least  90 percent of the clips. |Maximum clip size should be set in Select options|Click Next to start."	"Un clip est une phrase ou un groupe de phrases parlées par une personne (ou le caractère). Dans le Nouveau Testament, il y a entre 4,000 à 6,000 clips. Dramatizer peut d'habitude identifier le caractère parlant à au moins 90 pour cent des clips. la grandeur de clip de |Maximum devrait être mise dans Choisissez es options|Click À côté du début."	"Um clipe é uma oração ou o grupo de orações ditas por uma pessoa (ou caráter). No Novo Testamento, há entre 4,000 para 6,000 clipes. O Dramatizer pode identificar normalmente o caráter que fala em pelo menos 90 por cento dos clipes. |O tamanho de clipe máximo deve ser estabelecido em Selecione opções |Clique ao Lado da partida."
0 unidentified	Dramatizer was able to identify all characters. There are no unidentified characters to identify. 	Dramatizer a été en mesure d'identifier tous les caractères. Il n'y a aucun caractère non identifié pour s'identifier.	O Dramatizer foi capaz de identificar todos os carateres. Não há nenhum caráter não identificado para identificar.
1 unidentified	Dramatizer was unable to identify who the character should be in one clip. Please identify the speaking character. 	Dramatizer était incapable de s'identifier qui le caractère devrait être dans un clip. Identifiez s'il vous plaît le caractère parlant.	O Dramatizer foi incapaz de identificar quem o caráter deve estar em um clipe. Por favor identifique o caráter que fala.
many unidentified	Dramatizer was unable to identify who the character should be in some clips. Please identify the speaking characters. 	Dramatizer était incapable de s'identifier qui le caractère devrait être dans quelques clips. Identifiez s'il vous plaît les caractères parlants.	O Dramatizer foi incapaz de identificar quem o caráter deve estar em alguns clipes. Por favor identifique os carateres falam.
Speaker/speaker number	Speaker number	Nombre de speaker	Número de falante
clip number	Clip number	Nombre de clip	Número de clipe
prompt	Prompt	Suggestion	Prompt
show context	Show context	Montrer Contexte	Contexto
hide context	Hide context	Cacher contexte	Hide context
advance to next	Clip	Clip	Clipe
advance by Unidentfied character clip	unidentified characters	caractères non identifiés	carateres não identificados
advance by Multiple characters clip	multiple characters	caractères multiples	múltiplos carateres
advance by my Updated clip	Updated character	Caractère actualisé	Caráter atualizado
0 multiple	Dramatizer was able to identify all multiple characters (maybe with some help from you). There are no multiple characters to identify. 	Dramatizer était capable d'identifier tous les caractères multiples (peut-être avec un peu d'aide de vous). Il n'y a aucun caractère multiple pour s'identifier.	O Dramatizer foi capaz de identificar todos múltiplos carateres (talvez com um pouco de ajuda de você). Não há nenhum múltiplo caráter para identificar.
1 multiple	Dramatizer was able to identify the characters in one verse that had multiple characters per verse. Please review all of these choices to make sure the program didn't make a mistake.	Dramatizer était capable d'identifier les caractères dans un verset qui avait des caractères multiples par verset. Reconsidérez s'il vous plaît tous ces choix pour vous assurer que le programme n'a pas fait d'erreur.	O Dramatizer foi capaz de identificar os carateres em um verso que teve múltiplos carateres por verso. Por favor reveja todas dessas escolhas para assegurar-se que o programa não fez um erro.
many multiples	Dramatizer was able to identify the characters in verses that had multiple characters per verse. Please review all of these choices to make sure the program didn't make a mistake.	Dramatizer a été en mesure d'identifier les caractères dans les versets qui avaient des caractères multiples par verset. Reconsidérez s'il vous plaît tous ces choix pour vous assurer que le programme n'a pas fait d'erreur.	O Dramatizer foi capaz de identificar os carateres em versos que tiveram múltiplos carateres por verso. Por favor reveja todas dessas escolhas para assegurar-se que o programa não fez um erro.
warning deleting active master file	Warning: This will delete your previously processed and saved work.|	Avertissement : Cela effacera votre travail auparavant traité et enregistré. |	Aviso: Isto eliminará o seu trabalho anteriormente processado e salvado. |
translate menu items	Translate/correct menu items	Traduire/corriger items de menu	Traduza/corrija itens de cardápio
file name	File name	Nom de dossier	Nome de arquivo
browse	Browse …. . .	Parcourez . . .	Brotos ternos AIU-...
font name	Font name	Nom de fonte	Nome de fonte
font size	Font size	Grandeur de fonte	Tamanho de fonte
quote type	Quote type	Type de citation	Tipo de citação
audio recording program	Audio recording program	Programme d'enregistrement audio	Programa de registro auditivo
display quotes	Display quotes	Citations d'étalage	Citações de exposição
text encoding	Text encoding	Texte encodant	Codificação de texto
ansi	ANSI	ANSI	ANSI
utf8	UTF-8	UTF-8	UTF-8
cancel	Cancel	Annuler	Cancelamento
set options	Set options	Options de jeu	Opções de jogo
current location number	Current location number	Nombre d'endroit actuel	Número de posição atual
ok	OK	Bien	OK
update	Update	Mise à jour	Atualização
edit	Edit	Réviser	Editar
maximum clip size	Maximum clip size in seconds (approximate) 	La longueur de clip maximum en secondes (approximatives)	Tamanho de clipe máximo em segundos (aproximados)
Ethnologue code	Ethnologue code	Code d'Ethnologue	Código de Ethnologue
Heading	Headings \h	Titres \h	Títulos \h
Introduction	Introductions \is \ip and \id	Les Introductions \is \ip et \id	Introduções \is \ip e \id
Section heads	Section heads \s	Titres de section  \s	Seção encabeça \s
Footnotes	Footnotes \f…\f*	Les Notes en bas de page \f \f*	Notas \f \f*
References	References \r	Références \r	Referências \r
Chapter number	Chapter numbers \c	Nombres de chapitre \c	Números de capítulo \c
Don't speak these	Remove from final scripts	Enlever des scripts finaux	Retire de escritas finais
Character name	Character name	Nom de caractère	Nome de caráter
no INI file (short)	No INI file found.	Aucun dossier INI trouvé.	Nenhum arquivo INI encontrado.
no INI file (long)	An INI file will be created when you save settings. This will keep your settings that you choose.	Un dossier INI sera créé quand vous enregistrez des désignations. Cela gardera vos dé??? que vous choisissez.	Um arquivo INI será criado quando você salva colocações. Isto guardará as suas colocações que você escolhe.
correct the text	Please correct the problem in the source text.	Corrigez s'il vous plaît le problème du texte source.	Por favor corrija o problema no texto de fonte.
unable to process text	Unable to process the text.	Incapable de traiter le texte.	Incapaz de processar o texto.
verify opening quote 	Verify that the opening quote	Vérifiez que la citation préliminaire	Verifique isto a citação que se abre
continue verify opening quote	found after the start of this text is really a continuing quote marker. If it is not a continuing quote marker then there is a problem.	trouvé après que le début de ce texte est vraiment un marqueur de citation continuant. Si ce n'est pas un marqueur de citation continuant alors il y a un problème.	encontrado depois que a partida deste texto é realmente um marcador de citação de continuação. Se ele não for um marcador de citação de continuação então há um problema.
continuing quote?	Is this a continuing quote marker?	Est-ce que c'est un marqueur de citation continuant ?	Isto é um marcador de citação de continuação?
second quote found	Second opening quote mark found	Deuxième marque de citation préliminaire trouvée	Segunda marca de citação de abertura encontrada
text unusable	Dramatizer will not be able to use this text until this is corrected. Please look at the original text and see if it is possible that a closing quote marker is missing. Look for a closing quote marker found inside of a footnote. All footnotes (\f..\f*) and references (\r) are discarded at the start of processing the text in Dramatizer. Make sure that you have checked the quotations with a tool such as Paratext scripture checks.  Please correct the problem in the source text.	Dramatizer ne sera pas capable d'utiliser ce texte jusqu'à ce que ce soit corrigé. Regardez s'il vous plaît le texte original et voir s'il est possible qu'un marqueur de citation final manque. Cherchez un marqueur de citation final trouvé à l'intérieur d'une note en bas de page. Toutes les notes en bas de page (\f ...\f *) et les références (\r) sont débarrassées au début de traiter le texte dans Dramatizer. Assurez-vous que vous avez vérifié les citations avec un instrument comme les vérifications de Sainte Écriture de Paratexte. Corrigez s'il vous plaît le problème du texte source.	O Dramatizer não será capaz de usar este texto até que isto seja corrigido. Por favor veja o texto original e ver se é possível que um marcador de citação final esteja falhando. Procure um marcador de citação final encontrado dentro de uma nota ao pé de uma página. Todas as notas (\f ...\f *) e referências (\r) são descartadas na partida de processar o texto em Dramatizer. Assegure-se que você verificou as cotações com um instrumento como cheques de Sagrada Escritura de Paratexto. Por favor corrija o problema no texto de fonte.
see more problems	Do you see if there are other problems?	Voyez-vous d'autres problèmes ?	Você para ver se há outros problemas?
continuing quote tip	Tip: Continuing quote markers usually follow immediately after \p or possible \p \v markers. An opening quote marker following a colon is most likely an error.	Bout : les marqueurs de citation continuants suivent d'habitude immédiatement après \p ou les marqueurs \p\v possibles. Un marqueur de citation préliminaire après des deux-points est le fort probablement une erreur.	Ponta: os marcadores de citação continuam normalmente seguem imediatamente depois \p ou marcadores \p\v possíveis. Um marcador de citação que se abre depois de um dois-pontos é mais provável um erro.
fileReadError	File reading error	Erreur en lisant le dossier	Arquivo lendo erro
Unidentified characters to fix	unidentified characters to fix	les caractères non identifiés pour fixer	carateres não identificados para fixar
Multiple characters to fix	multiple characters to fix	les caractères multiples pour fixer	múltiplos carateres para fixar
totalClips	total clips	clips totaux	clipes totais
Clips to record	clips to record	les clips pour enregistrer	clipes para registrar
ClickNextToStart	Click Next to start.	Faites un déclic À côté du début.	Clique ao Lado da partida.
VerifyUpdatedText	Verify just the characters you have selected or typed in. Skip over all the ones that the Dramatizer program supplied.	Vérifiez juste les caractères que vous avez choisis ou avez tapés. Ne tenez pas compte de tout ceux que le programme Dramatizer fourni.	Verifique somente os carateres que você selecionou ou datilografou. Omita por cima de todo aqueles que o programa Dramatizer forneceu.
VerifyAllText	Verify all characters. You must do this before assigning characters to speakers.	Vérifiez tous les caractères. Vous devez le faire avant le fait d'allouer des caractères aux speakers.	Verifique todos os carateres. Você deve fazer isto antes de destinar carateres a falantes.
AssignCharacterToSpeakerText	Assign each character to a speaker. Speaker zero is used for unassigned characters. There should be very few that you will need to do. Just new characters.	Allouez chaque caractère à un speaker. Le zéro de speaker est utilisé pour les caractères non alloués. Il devrait y avoir très peu que vous aurez besoin de faire. Seulement les nouveaux caractères.	Destine cada caráter a um falante. O zero de falante é usado para carateres não destinados. Devem haver muito poucos que você terá de fazer. Carateres somente novos.
CreateScriptsText	"In the scripts folder, create a master script and a script for each speaker. Scripts are html files that can be printed out. In the recordings folder create a blank wave file for each clip."	"Dans la chemise de scripts, créez un script de maître et un script pour chaque speaker. Les scripts sont des dossiers Html qui peuvent être imprimés. Dans la chemise d'enregistrements créez un dossier d'ondes blanc pour chaque clip."	"Na pasta de escritas, crie uma escrita de mestre e uma escrita de cada falante. As escritas são arquivos de html que podem ser imprimidos. Nos registros pasta criam um arquivo de onda em branco de cada clipe."
RecordText	Start recording now	Commencez à enregistrer maintenant	Comece a registrar agora
UnassignedCharactersToFix	unassigned characters to fix	les caractères non alloués pour fixer	carateres não destinados para fixar
showVerses	Show verses	Montrer les versets	Versos de demonstração
showSFMcodes	Show SFM codes	Montrez des codes de SFM	Mostre códigos de SFM
showSpeakerText	Show speaker text	Montrez le texte de speaker	Mostre o texto de falante
useSettingsToAdjustClipSize	Use settings to adjust clip size	Utilisez des cadres pour régler la grandeur de clip	Use colocações para ajustar o tamanho de clipe
inputTab	Input	Contribution	Entrada
quoteTypeTab	Quote type	Type de citation	Tipo de citação
omitTextTab	Omit text	Omettez le texte	Omita texto
recordingProgramTab	Audio recording program	Programme d'enregistrement audio	Programa de registro auditivo
clipSizeTab	Clip size	Grandeur de clip	Tamanho de clipe
EthnologueCodeTab	Ethnologue code	Code d'Ethnologue	Código de Ethnologue
outputTab	Output	Production	Produção
displayUnrecordedOn ly	Display only clips to be recorded	Montrez seulement des clips à être enregistrés	Mostre só clipes a ser registrados
recordOneSpeakerAtATime	Record one speaker at a time	Enregistrez un speaker à la fois	Registre um falante de uma vez
showPrompt	Show prompt	Montrer suggestion	Demonstração pronto
fontTab	Font	Fonte	Fonte
OmitThisOne	Omit this one	Omettez celui-ci	Omita este
OutputFolder	Dramatizer output folder	Chemise de production de Dramatizer	Pasta de produção de Dramatizer
SpeechContinuesInNextClip	Continues in next clip	Continue dans le clip suivant	Continua no seguinte clipe
ClipSize	Clip size in seconds (approximate)	La longueur de clip en secondes (approximatives)	Tamanho de clipe em segundos (aproximados)
PercentIdentified	 percent Dramatizer identified.	 le pour cent Dramatizer a identifié.	 os por cento Dramatizer identificaram.
BreakAtMostParagraphs	Break at most paragraphs	Pause à la plupart des paragraphes	Pause à la plupart des paragraphes
DefaultSettings	Reset to default settings	La remise des cadres originaux	Recomposição para faltar colocações
MasterText	Master text	Texte de maître	Texto de mestre
AvailableDiskSpaceC	Available Disk Space Drive C:	Espace Disponible sur disque C :	O Espaço de Disco Disponível Dirige C:
AvailableDiskSpaceD	available Disk Space Drive D:	Espace Disponible sur disque D :	O Espaço de Disco Disponível Dirige D:
NoteAQuote	Not a quote	Pas une citation	Não uma citação
DisplayUnprocessedOnly	Display only clips to process	Affichez seulement des clips pour traiter	Exponha só clipes para processar
DisplayOmittedClips	Display omitted clips too	Afficher les clips omis aussi	A exposição omitiu clipes também
SaveChangeAndSeeNext	"Save change, see next item"	"Enregistrez le changement, voir l'article suivant"	"Salve a modificação, ver o seguinte item"
CancelChangeAndCloseMenu	Cancel change and close translate menu.	Annuler le changement et fermer le menu de traduction.	A modificação de cancelamento e perto traduz o cardápio.
SaveChangeAndCloseMenu	Save change and close translate menu.	Enregistrer le changement et fermer le menu de traduction.	Salve a modificação e perto traduza o cardápio.
BackAndCancelChange	"Go back, cancel any change."	"Retournez, annulez n'importe quel changement."	"Volte, cancele qualquer modificação."
GoToStart	Go to first item.	Allez au premier article.	Vá ao primeiro item.
TypeInOtherBox	Type your changes in other box please.	Tapez vos changements dans l'autre boîte s'il vous plaît.	Datilografe as suas modificações em outra caixa por favor.
MoveToTopRight	Move this up	Mettez-le plus haut	Suba isto
MoveToBottomLeft	Move this down	Mettez-le en bas	Mova isto abaixo
More	More	Plus	Mais
Less	Less	Moins	Menos
DisplayClipsBy	Display clips by	Afficher clips par	Clipes de exposição por
All	All	Tous	Todos
Unidenfied	Unidentified	Non identifié	Não identificado
Multiple	Multiple	Multiple	Múltiplo
CharacterName	Character name	Nom de caractère	Nome de caráter
SpeakerNumber	Speaker number	Nombre de speaker	Número de falante
CongratulationsRecord	Congratulations! You are ready to start recording. Make sure you have the correct audio recording program selected in Select options. You may record in sequence or by speaker number. The default is to record by speaker number. Output files (wav) are located at:	Félicitations! Vous êtes prêts à commencer à enregistrer. Assurez-vous que vous avez le programme d'enregistrement audio correct choisi dans les options d'Élection. Vous pouvez enregistrer dans l'ordre ou par le nombre de speaker. Le défaut doit enregistrer par le nombre de speaker. Les dossiers de production (wav) sont trouvés à :	Congratulações! Você está pronto para começar a registrar. Assegure-se que você tem o programa de registro auditivo correto selecionado em Selecionam opções. Você pode registrar na seqüência ou pelo número de falante. O default deve registrar pelo número de falante. Os arquivos de produção (wav) são localizados em :
MoveUp	Move up	Monter	Subir
MoveDown	Move down	Descendre	Movimento abaixo
RecordSpeaker	 more clips remain for this speaker	 plus de clip(s) reste pour ce speaker	mais clipe(s) permanece para este falante
RecordTotal	 more clips remain total	 plus de clip(s) reste total	mais clipe(s) permanece total
AllScriptsAndWavFilesCreated	All scripts and wav files were created. Look in [output folder]\scripts and [output folder]\recordings.	Tous les scripts et les fichiers d'ondes étaient créés. Cherchez dans la chemise []\scripts et [chemise de production]\enregistrements.	Todas as escritas e os arquivos wav foram criados. Olhada [em pasta de produção] \scripts e [pasta de produção] \recordings.
SpeakerText	Text	Texte	Texto
TextEncodingTab	Text encoding	Texte encodant	Codificação de texto
Required information missing	Required information missing	Manque d'information nécessaire	Ausência de informações necessitada
PleaseCorrect	Please correct	Corrigez s'il vous plaît	Por favor corrija
Processing	Processing	Traitement	Processing …
AddNew	Add new menu language	Ajoutez une nouvelle langue de menu	Add new menu language
CorrectCurrentMenu	Correct current menu	Corrigez le menu actuel	Correct current menu
